##########################
##########################
##..#..#.........#,...####
##..#.,.#........###.##.##
##..#...#..#####........##
##..#...................##
##.........#.@.#........##
##.#.......#!..#........##
##.#..#.....##..........##
##.#.#..#..,..#.........##
##..###########.........##
###.......,.###......,..##
##########################
##########################