###############
#@.#.......####
#..#...#......#
#..#..........#
#.............#
#.#...........#
#.#..#........#
#.#.#..#.....##
#..############
##.........####
###############