####################################
####################################
##..#..##,....####,...#.#########,##
##..#.,.##.......###.##...........##
##..#...########.....##...........##
##..#.........#......##...........##
##.........#..#......##..........##
##.........#...#.....##....######.##
##.#.......#!@.#..####..#########.##
##.#..#.....##..........#########.##
##.#.#..#..,..#.........##........##
##..###################.##........##
###.......,.###......,..###,.##..###
#...#####...###################..###
####################################
####################################